.....O-------O......
.....I.......I......
.....I.......I......
.....I...@...I......
O----O-OPOPO-O----O.
I....1.......2....I.
I................*I.
O----OPO-O-OPO----O.
.....I.......I......
.....I...3...I......
.....I.......I......
.....O--O$O--O......